jp.co.ponos.battlecats.nekokan1	eio1z3
jp.co.ponos.battlecats.nekokan2	wxgzyz
jp.co.ponos.battlecats.nekokan3	lixf65
jp.co.ponos.battlecats.nekokan4	gn1pis
jp.co.ponos.battlecats.nekokan5	bs8lam
jp.co.ponos.battlecats.nekokan6	mss97u
jp.co.ponos.battlecats.nekokan7	b3orcc
jp.co.ponos.battlecats.nekokan8	nno3yt
jp.co.ponos.battlecats.nekokan_pack1	w9iysj	åˆå¿ƒè€…ãƒ‘ãƒƒã‚¯600å††
jp.co.ponos.battlecats.nekokan_pack2	dvsusf	åˆå¿ƒè€…ãƒ‘ãƒƒã‚¯1400å††
jp.co.ponos.battlecats.nekokan_pack3	egjaj8	åˆå¿ƒè€…ãƒ‘ãƒƒã‚¯3600å††	
jp.co.ponos.battlecats.rankup_sale1	q42eqv	ãƒ©ãƒ³ã‚¯ã‚¢ãƒƒãƒ—ã‚»ãƒ¼ãƒ«ãƒã‚³ã‚«ãƒ³
jp.co.ponos.battlecats.rankup_sale2	gsz6wf	ãƒ©ãƒ³ã‚¯ã‚¢ãƒƒãƒ—ã‚»ãƒ¼ãƒ«çµŒé¨“å€¤
jp.co.ponos.battlecats.rankup_sale3	uzfolj	ãƒ©ãƒ³ã‚¯ã‚¢ãƒƒãƒ—ã‚»ãƒ¼ãƒ«ã‚¢ã‚¤ãƒ†ãƒ å¤§ç››ã‚Šãƒ‘ãƒƒã‚¯
jp.co.ponos.battlecats.item_pack1	doq698	ã‚¢ã‚¤ãƒ†ãƒ ãƒ‘ãƒƒã‚¯600å††
jp.co.ponos.battlecats.item_pack2	57fuj0	ã‚¢ã‚¤ãƒ†ãƒ ãƒ‘ãƒƒã‚¯1400å††
jp.co.ponos.battlecats.item_pack3	favert	ã‚¢ã‚¤ãƒ†ãƒ ãƒ‘ãƒƒã‚¯3600å††
jp.co.ponos.battlecats.matatabi_set1	g6u8ci	ãƒã‚¿ã‚¿ãƒ“ã‚»ãƒƒãƒˆ2400å††
jp.co.ponos.battlecats.matatabi_set2	wupgmf	ãƒã‚¿ã‚¿ãƒ“ã‚»ãƒƒãƒˆ4800å††
jp.co.ponos.battlecats.matatabi_set3	7ygur8	ãƒã‚¿ã‚¿ãƒ“ã‚»ãƒƒãƒˆ9800å††
jp.co.ponos.battlecats.platinum_ticket	luoi35
jp.co.ponos.battlecats.rare_ticket	2n3k45
jp.co.ponos.battlecats.chara_479	zfrp1m	ã‚°ãƒŸãƒã‚³
jp.co.ponos.battlecats.nyanko_club	sq6uhv	ã«ã‚ƒã‚“ã“ã‚¯ãƒ©ãƒ–ã‚´ãƒ¼ãƒ«ãƒ‰ä¼šå“¡æ¨©
jp.co.ponos.battlecats.restart	shj596	ã€Œãƒªã‚¹ã‚¿ãƒ¼ãƒˆãƒ‘ãƒƒã‚¯ã€
jp.co.ponos.battlecats.daikansha_set	x2oq0n	ã€Œå¤§æ„Ÿè¬ãƒ‘ãƒƒã‚¯ã€
jp.co.ponos.battlecats.super_set1	a5snea	ã€Œè¶…é™å®šã‚»ãƒ¼ãƒ«ï¼ãƒã‚³ã‚«ãƒ³ãƒ‘ãƒƒã‚¯è¶…æ¢…ã€
jp.co.ponos.battlecats.super_set2	4fve88	ã€Œè¶…é™å®šã‚»ãƒ¼ãƒ«ï¼ãƒã‚³ã‚«ãƒ³ãƒ‘ãƒƒã‚¯è¶…ç«¹ã€
jp.co.ponos.battlecats.super_set3	t2fhhw	ã€Œè¶…é™å®šã‚»ãƒ¼ãƒ«ï¼ãƒã‚³ã‚«ãƒ³ãƒ‘ãƒƒã‚¯è¶…æ¾ã€
jp.co.ponos.battlecats.premium_sale	u95m8y	ãŠã‚ã§ã¨ã†ã‚»ãƒ¼ãƒ«
jp.co.ponos.battlecats.chara_558	djhkmh	ã‚­ãƒ£ãƒ©ã€Œãƒ¬ã‚¢ã‚¬ãƒãƒ£ãƒã‚³ã€è²©å£²
jp.co.ponos.battlecats.chara_567	4stkcz	ã‚­ãƒ£ãƒ©ã€Œãƒãƒ“ã‚¯ãƒ­ãƒ—ã‚¹ãƒã‚³ã‚¿ãƒã‚´ã€è²©å£²
jp.co.ponos.battlecats.legend_ticket	vabft2	ãƒ¬ã‚¸ã‚§ãƒ³ãƒ‰ãƒã‚±ãƒƒãƒˆè²©å£²
jp.co.ponos.battlecats.otasuke_sale1	xydr9a	ãŠåŠ©ã‘ã‚»ãƒ¼ãƒ«ï¼ãƒã‚³ãƒœãƒ³3æ™‚é–“ä½¿ã„æ”¾é¡Œ
jp.co.ponos.battlecats.otasuke_sale2	xbwcp9	ãŠåŠ©ã‘ã‚»ãƒ¼ãƒ«ï¼ãƒ‹ãƒ£ãƒ³ãƒ”ãƒ¥ãƒ¼ã‚¿3æ™‚é–“ä½¿ã„æ”¾é¡Œ
jp.co.ponos.battlecats.otasuke_sale3	w7zevp	ãŠåŠ©ã‘ã‚»ãƒ¼ãƒ«ï¼ã‚¹ãƒ‹ãƒ£ã‚¤ãƒ‘ãƒ¼3æ™‚é–“ä½¿ã„æ”¾é¡Œ
jp.co.ponos.battlecats.chara_608	vbylqy	é™å®šã‚­ãƒ£ãƒ©ã€Œãƒã‚³ã‚¦ã‚¨ãƒãƒ¼ã‚¹ã€è²©å£²
jp.co.ponos.battlecats.powerup_sale1	3h4mys	ãƒ‘ãƒ¯ãƒ¼ã‚¢ãƒƒãƒ—ã‚»ãƒ¼ãƒ«ï¼ãƒã‚³ã‚«ãƒ³&ã‚¢ã‚¤ãƒ†ãƒ ãƒ‘ãƒƒã‚¯æ¢…
jp.co.ponos.battlecats.powerup_sale2	irk7al	ãƒ‘ãƒ¯ãƒ¼ã‚¢ãƒƒãƒ—ã‚»ãƒ¼ãƒ«ï¼ãƒã‚³ã‚«ãƒ³&ã‚¢ã‚¤ãƒ†ãƒ ãƒ‘ãƒƒã‚¯ç«¹
jp.co.ponos.battlecats.powerup_sale3	q6lytb	ãƒ‘ãƒ¯ãƒ¼ã‚¢ãƒƒãƒ—ã‚»ãƒ¼ãƒ«ï¼ãƒã‚³ã‚«ãƒ³&ã‚¢ã‚¤ãƒ†ãƒ ãƒ‘ãƒƒã‚¯æ¾
jp.co.ponos.battlecats.kansha_set	mydbdm	æ„Ÿè¬ãƒ‘ãƒƒã‚¯
jp.co.ponos.battlecats.nekokan1_1	eio1z3
jp.co.ponos.battlecats.nekokan2_1	wxgzyz
jp.co.ponos.battlecats.nekokan3_1	lixf65
jp.co.ponos.battlecats.nekokan4_1	gn1pis
jp.co.ponos.battlecats.nekokan5_1	bs8lam
jp.co.ponos.battlecats.nekokan6_1	mss97u
jp.co.ponos.battlecats.nekokan7_1	b3orcc
jp.co.ponos.battlecats.nekokan8_1	nno3yt
jp.co.ponos.battlecats.nekokan_pack1_1	w9iysj	åˆå¿ƒè€…ãƒ‘ãƒƒã‚¯600å††
jp.co.ponos.battlecats.nekokan_pack2_1	dvsusf	åˆå¿ƒè€…ãƒ‘ãƒƒã‚¯1400å††
jp.co.ponos.battlecats.nekokan_pack3_1	egjaj8	åˆå¿ƒè€…ãƒ‘ãƒƒã‚¯3600å††
jp.co.ponos.battlecats.rankup_sale1_1	q42eqv	ãƒ©ãƒ³ã‚¯ã‚¢ãƒƒãƒ—ã‚»ãƒ¼ãƒ«ãƒã‚³ã‚«ãƒ³
jp.co.ponos.battlecats.rankup_sale2_1	gsz6wf	ãƒ©ãƒ³ã‚¯ã‚¢ãƒƒãƒ—ã‚»ãƒ¼ãƒ«çµŒé¨“å€¤
jp.co.ponos.battlecats.rankup_sale3_1	uzfolj	ãƒ©ãƒ³ã‚¯ã‚¢ãƒƒãƒ—ã‚»ãƒ¼ãƒ«ã‚¢ã‚¤ãƒ†ãƒ å¤§ç››ã‚Šãƒ‘ãƒƒã‚¯
jp.co.ponos.battlecats.item_pack1_1	doq698	ã‚¢ã‚¤ãƒ†ãƒ ãƒ‘ãƒƒã‚¯600å††
jp.co.ponos.battlecats.item_pack2_1	57fuj0	ã‚¢ã‚¤ãƒ†ãƒ ãƒ‘ãƒƒã‚¯1400å††
jp.co.ponos.battlecats.item_pack3_1	favert	ã‚¢ã‚¤ãƒ†ãƒ ãƒ‘ãƒƒã‚¯3600å††
jp.co.ponos.battlecats.rare_ticket_1	2n3k45
jp.co.ponos.battlecats.legend_ticket_1	vabft2	ãƒ¬ã‚¸ã‚§ãƒ³ãƒ‰ãƒã‚±ãƒƒãƒˆè²©å£²
jp.co.ponos.battlecats.kansha_set_1	mydbdm	æ„Ÿè¬ãƒ‘ãƒƒã‚¯
jp.co.ponos.battlecats.daikansha_set_1	x2oq0n	ã€Œå¤§æ„Ÿè¬ãƒ‘ãƒƒã‚¯ã€
jp.co.ponos.battlecats.super_set1_1	a5snea	ã€Œè¶…é™å®šã‚»ãƒ¼ãƒ«ï¼ãƒã‚³ã‚«ãƒ³ãƒ‘ãƒƒã‚¯è¶…æ¢…ã€
jp.co.ponos.battlecats.super_set2_1	4fve88	ã€Œè¶…é™å®šã‚»ãƒ¼ãƒ«ï¼ãƒã‚³ã‚«ãƒ³ãƒ‘ãƒƒã‚¯è¶…ç«¹ã€
jp.co.ponos.battlecats.super_set3_1	t2fhhw	ã€Œè¶…é™å®šã‚»ãƒ¼ãƒ«ï¼ãƒã‚³ã‚«ãƒ³ãƒ‘ãƒƒã‚¯è¶…æ¾ã€
jp.co.ponos.battlecats.matatabi_set1_1	g6u8ci	ãƒã‚¿ã‚¿ãƒ“ã‚»ãƒƒãƒˆ2400å††
jp.co.ponos.battlecats.matatabi_set2_1	wupgmf	ãƒã‚¿ã‚¿ãƒ“ã‚»ãƒƒãƒˆ4800å††
jp.co.ponos.battlecats.matatabi_set3_1	7ygur8	ãƒã‚¿ã‚¿ãƒ“ã‚»ãƒƒãƒˆ9800å††
jp.co.ponos.battlecats.powerup_sale1_1	3h4mys	ãƒ‘ãƒ¯ãƒ¼ã‚¢ãƒƒãƒ—ã‚»ãƒ¼ãƒ«ï¼ãƒã‚³ã‚«ãƒ³&ã‚¢ã‚¤ãƒ†ãƒ ãƒ‘ãƒƒã‚¯æ¢…
jp.co.ponos.battlecats.powerup_sale2_1	irk7al	ãƒ‘ãƒ¯ãƒ¼ã‚¢ãƒƒãƒ—ã‚»ãƒ¼ãƒ«ï¼ãƒã‚³ã‚«ãƒ³&ã‚¢ã‚¤ãƒ†ãƒ ãƒ‘ãƒƒã‚¯ç«¹
jp.co.ponos.battlecats.powerup_sale3_1	q6lytb	ãƒ‘ãƒ¯ãƒ¼ã‚¢ãƒƒãƒ—ã‚»ãƒ¼ãƒ«ï¼ãƒã‚³ã‚«ãƒ³&ã‚¢ã‚¤ãƒ†ãƒ ãƒ‘ãƒƒã‚¯æ¾
jp.co.ponos.battlecats.rankup_sale4_1	o7r9i3	ãŠå¾—ï¼ãƒã‚³ã‚«ãƒ³ãƒ‘ãƒƒã‚¯
jp.co.ponos.battlecats.rankup_sale5_1	kwmk4a	è¶…ãŠå¾—ï¼çµŒé¨“å€¤ãƒ‘ãƒƒã‚¯
jp.co.ponos.battlecats.rankup_sale6_1	w139sx	è¶…ãŠå¾—ï¼ã‚­ãƒ£ãƒƒãƒ„ã‚¢ã‚¤&ãƒãƒˆãƒ«ã‚¢ã‚¤ãƒ†ãƒ ãƒ‘ãƒƒã‚¯
jp.co.ponos.battlecats.rare_ticket2_1	ngeip7	ã‚­ãƒ£ãƒƒãƒ„ã‚¢ã‚¤&ãƒ¬ã‚¢ãƒã‚±ãƒƒãƒˆã‚»ãƒƒãƒˆ
jp.co.ponos.battlecats.kouryaku_set_1	prmczd	æ”»ç•¥å¿œæ´ãƒ‘ãƒƒã‚¯